#
# 0 E room0.txt 0
#
WWWWWWWWWW
W    S   W
WS      SW
W  WWWWWWW
WWWWWWW  W
W  WWWWWWW
WWWWWWW  W
W  WWWWWWW
WWWWWWW  W
W0WWWWWWWW