WWWW0WWWWW
W        W
W        W
WWWWW    W
W   W    W
W   W  WWW
W  H     W
W        W
W     T  W
WWWWWWWWWW
