#
# 0 o room0.txt 1
# 1 ^ room4.txt 1
# 2 v room4.txt 2
#
WWWWWWWWWW
W1     G W
W    WWWWW
W W  W  2W
W W  W   W
W W  W   W
W W  W S W
WWW TW   W
W0     B W
WWWWWWWWWW