#
# 0 E room0.txt 0
# 1 E room2.txt 0
#
WWWWWWWWWW
WS   W S W
WWW      W
W    W   W
W  W  W  W
W  W  W  W
W  W  W  W
W  W  W  W
W W   SW W
W1WWWWWW0W
