#
# 0 E room0.txt 0
#
WWWWWWWWWW
WS     S W
W  S     W
W  WWWWWWW
W        W
WWWWWWW  W
W        W
W  WWWWWWW
W        W
WWWWWWWW0W